9
25
##########################
#                        #
#     ##############     #
# ####      ^       ##   #
#   ##           i    ## #
#   ##  i   @         ## #
# ####              ##   #
#     ##############     #
#                        #
##########################
. 
