6
22
    ##############     
####      ^       ##  
  ##           i    ##
  ##  i   @         ##
####              ##  
    ##############   
. 
