"                    ######################                                      ",
        "                #####       ######      #####                                   ",
        "              ####          ######         ####                                 ",
        "       #########            ######           #########                          ",
        "     ####                   ######                  #####                       ",
        "   ####                     ######                     ####                     ",
        "#####                      ########                      #####                  ",
        "##              *        ###########                       ##       ########    ",
        "##                      ##############                      ##      ##      ##  ",
        "##                     ################                     #########        #  ",
        "##     @               ################                                  ^   #  ",
        "##                     ################                     ######### i      #  ",
        "##                      ##############                      ##      ##      ##  ",
        "##                       ############             *         ##       ########   ",
        "####                       ########                      #####                  ",
        "  ####                                                 ####                     ",
        "    #####                            i              #####                       ",
        "       #########           *                 ########                           ",
        "              ####                         ####                                 ",
        "                #####                   #####                                   ",
                   #######################                                      ",

